2016111577
2017111809
2017111810
2017111811
2017111812
2017111813
2017111814
2017111815
2017111816
2017111817
2017111818
2017111819
2017111820
2017111821
2017111822
2017111823
2017111824
2017111825
2017111826
2017111828
2017111829
2017111830
2017111832
2017111833
2017111834
2017111835
2017111836
2017111837
2017111838
2017111839
2017111840
2017111841
2017111842
2017110652
2017111695
2017111696
2017111697
2017111698
2017111700
2017111701
2017111702
2017111703
2017111704
2017111705
2017111706
2017111707
2017111708
2017111709
2017111711
2017111712
2017111713
2017111714
2017111715
2017111716
2017111717
2017111718
2017111719
2017111720
2017111721
2017111722
2017111724
2017111725
2017111726
2017111727
2017111728
2017111729
2017111730
2017111731
2017111732
2017111733
2017110660
2017111734
2017111735
2017111736
2017111737
2017111738
2017111739
2017111740
2017111741
2017111742
2017111743
2017111744
2017111745
2017111746
2017111747
2017111748
2017111749
2017111750
2017111751
2017111752
2017111753
2017111754
2017111755
2017111756
2017111757
2017111758
2017111759
2017111760
2017111761
2017111762
2017111763
2017111764
2017111765
2017111766
2017111767
2017111768
2017111769
2017110684
2017111770
2017111771
2017111772
2017111773
2017111774
2017111775
2017111776
2017111777
2017111778
2017111779
2017111780
2017111781
2017111782
2017111783
2017111784
2017111785
2017111786
2017111787
2017111788
2017111789
2017111790
2017111791
2017111792
2017111793
2017111794
2017111795
2017111796
2017111797
2017111798
2017111799
2017111800
2017111801
2017111802
2017111803
2017111804
2017111805
2017111806
2017111807
2017111808
