2016111271
2016111272
2016111273
2016111274
2016111275
2016111276
2016111277
2016111278
2016111279
2016111280
2016111281
2016111282
2016111283
2016111284
2016111285
2016111286
2016111287
2016111288
2016111289
2016111290
2016111291
2016111292
2016111293
2016111294
2016111295
2016111296
2016111297
2016111298
2016111299
2016111300
2016111301
2016111302
2016111303
2016111304
2016111305
2016111306
