2017110684
2017111770
2017111771
2017111772
2017111773
2017111774
2017111775
2017111776
2017111777
2017111778
2017111779
2017111780
2017111781
2017111782
2017111783
2017111784
2017111785
2017111786
2017111787
2017111788
2017111789
2017111790
2017111791
2017111792
2017111793
2017111794
2017111795
2017111796
2017111797
2017111798
2017111799
2017111800
2017111801
2017111802
2017111803
2017111804
2017111805
2017111806
2017111807
2017111808
2016111577
2017111809
2017111810
2017111811
2017111812
2017111813
2017111814
2017111815
2017111816
2017111817
2017111818
2017111819
2017111820
2017111821
2017111822
2017111823
2017111824
2017111825
2017111826
2017111828
2017111829
2017111830
2017111832
2017111833
2017111834
2017111835
2017111836
2017111837
2017111838
2017111839
2017111840
2017111841
2017111842
