2017110652
2017111695
2017111696
2017111697
2017111698
2017111700
2017111701
2017111702
2017111703
2017111704
2017111705
2017111706
2017111707
2017111708
2017111709
2017111711
2017111712
2017111713
2017111714
2017111715
2017111716
2017111717
2017111718
2017111719
2017111720
2017111721
2017111722
2017111724
2017111725
2017111726
2017111727
2017111728
2017111729
2017111730
2017111731
2017111732
2017111733
2017110660
2017111734
2017111735
2017111736
2017111737
2017111738
2017111739
2017111740
2017111741
2017111742
2017111743
2017111744
2017111745
2017111746
2017111747
2017111748
2017111749
2017111750
2017111751
2017111752
2017111753
2017111754
2017111755
2017111756
2017111757
2017111758
2017111759
2017111760
2017111761
2017111762
2017111763
2017111764
2017111765
2017111766
2017111767
2017111768
2017111769
